d00wwwww0w00www
0w00000w0ww0w00
00ww0w000w0000w
w000wwww000wwww
000w00000www00w
ww0wwww0ww000ww
000www00000wwww
0w000ww0w0ww00w
0ww0w000w0000ww
www00wwww0wwwww
www0ww0w00ww000
w000w00w0ww00w0
00ww00w00000ww0
w0ww00ww0ww0ww0
w0000www00w000a
